########################
#..........M...........#
#..@.......#...........#
#..........#...........#
#..........#...........#
########################
