########################
#......M...........M....#
#..@.....#........#.....#
#........#........#.....#
#......M.#........#.....#
########################
