########################
#..M....M....M..........#
#..@.....#.....#.........#
#........#.....#.........#
#..M.....#.....#.........#
########################
