########################
#..............#.......#
#..@...........#.......#
#..............#.......#
########################
